19 13 31
###############################
#p      *     * ***   *    6  #
# #*# #*# #*# # #*# # # # # # #
#        * * x*      * 3  *   #
# # #*# # # # # #*# # #7# # # #
#*   *          *      *    * #
#*# # # #*# # #*# #*#*# #7# #b#
#  **        *1     *    *    #
# # # # # # # # # # # # # # # #
#      *            *        *#
# # # #x#*#*# #*#*#3# # # # # #
#        *           23      *#
###############################
