6 13 31
###############################
#p  3*  * * * 4      x     *  #
# # # # # # # #*# # # # # # # #
#     *3                      #
# # # #*# # #*# # #*#*# # #*# #
#          *   * 3  * *     * #
# # # # # # # # # # #*#*# # #*#
#         *  *     *  * *b    #
# # # # # # # # #*# # # #*#*# #
#***     *          *  *    * #
# #*#4# # # # # # #*# # # # #2#
# *x****       2    *   **    #
###############################
