48 13 31
###############################
#p       *6     * *x     * 5* #
# # # # # # # #*# # # # # #*#*#
#     * ***       *        7 *#
# # # # # # #5# # #*#7#*#*# #7#
#   *       * *  ***   * *    #
# # # # # # # # #x#*# #d# # # #
#*        *  **   ** *  *     #
# # #*#*#*# # # # # #*# # # # #
#**  *   *                    #
#7# # #7# # # # # #*#*# # # #*#
#         8   **    *     *7  #
###############################
