38 13 31
###############################
#p   *  *       **  *         #
# # # # # # #x# #*# # #*# # # #
# *    *      *       7    *  #
# # # # # # # # # # # # # # # #
# *  * * *   4     *    *   * #
# #*# #5# # # # #*# # # # # # #
#  * ** * 7  37       5 * *   #
# # # #3# # # # # # # # # # # #
#   *      **     *    *    **#
# #*# #f# # # # # # #*# # #x# #
# *   4      *5        *    * #
###############################
