11 13 31
###############################
#p   *    * *4         *   *  #
# # # # # # # # # #*# # #*# # #
#    **  * 35   ** ****   4   #
# # # # # # # # #*# # # # #*#*#
#   * *       3   *         * #
# # #*#*# # # # # #*#x# # #x# #
#* **      *  *  ** *   4  * *#
# # # # # # # # # #*# # # #*# #
#                   **      b #
# # # # # #*# # # # # # # # # #
# *     *    6    2   *       #
###############################
