30 13 31
###############################
#p    * x ***         6 * *   #
# # #*# # # #5#*# # # # #*# # #
#    x*   6*   ** ***   *    *#
# #e# #*# # # # # #7# # # # # #
#     3      ** *  *       *  #
#*# # #*#*# # #4#4# # # #*# # #
#     *     * *  *      * *  *#
# # # # #3# # # # # # #*# # # #
#         **      * 3    *  * #
# #*# # # # #*# # #*# # # # #*#
#  *    *     * * *           #
###############################
