40 13 31
###############################
#p       *  *    *            #
# # # # # #*#*# #4# # #3# # # #
#*    * *      *  *  *        #
# # # # # # # # # # # # #*# # #
#   *            *       * x* #
# # #*# # # # # # #5# #*# # # #
# *          *7   * * **  *   #
# #*# #*#5#7# #*#7# # # # # # #
#            *  * *  * *  **  #
#*# # # # # #*# # # # #*#7#*# #
#   4*  * * 5  *      x       #
###############################
