25 13 31
###############################
#p        **x   *       * 6   #
# # # # # #*# # # #*# # # # # #
# *x  **         *     *      #
# #*#5# # # # #*# # #5# #*# #*#
#         3           *       #
# # # # # # # # #*# # # # # # #
# *        * 2       *      * #
#*# # # # # #*#*# #m# # # # # #
#   *  6   * *          * 72* #
#*#*# # # #*# # # # #4#*# # #*#
#*   *   *   *     *  *       #
###############################
