9 13 31
###############################
#p               m **     *4  #
# # # # # # #*#*# #*#*# # #*# #
#  **                   * *   #
# # # # # # # # # # #x# #*# # #
#         *                2 *#
# # #*# # #4#*# # # #*#*#4# # #
# * *         ** *     5      #
#*# # # # # #*# # # #*# # # # #
#  x****       3 ***    ** * *#
# # # # # # #*# # # # #*# # # #
#4*     * *         **        #
###############################
