3 13 31
###############################
#p            ***        *  * #
# # # # # #x#*# # # # # #3# # #
#          *   *   **   2     #
# #x#*#*# #*# # # # # # #*# # #
#  *****   *    *        *    #
# # # # # # # #*#*#*# # # # # #
#    3                       *#
# # # # #*# #*# # # # # #*# # #
# *  *     2          1    *  #
# # # # # #*# #*# #*#*# # # #*#
#   1    *   *  *     d   *** #
###############################
