46 13 31
###############################
#p  *       *  *    *   **  * #
# # # #*# #*# # #7# # # # # #*#
#           *   5*x   *   *** #
# # # # # # # #*# # # # # # #*#
#         * *      * *        #
#*# # # # #7# #*# # # # # # # #
#  *   *      *     ** ** *   #
# # #7# # #*# # # # # # #*# # #
#   * *x*      67w   *    5   #
# #*# # #*# # # # # # #7# # # #
# *       *        6     7    #
###############################
