22 13 31
###############################
#p       *     **      d      #
# # # #*# # # # # #*# #*#*# # #
#          *   3*   7         #
# # # # # #x# #4#x# #*# # # # #
#* 3 *    * ***   *  ** 4     #
# #*# # # # #*# # #*# #*# # # #
#    *  4 **        * *** *  *#
# # #*# # # #*# #*#*#3# #*# # #
#  *** *       *     *        #
# #*#*# # # # #*# # #*# # # # #
#* *       5         3   *    #
###############################
