43 13 31
###############################
#p     **    *         *  **  #
# # # # #*#7# # # # # # # # # #
#   *   * 5           ***  7  #
# # # # # # # # # # # # #*# #*#
#      *   7   *  *      5    #
#*# # # # # #*# # #*# # # # # #
#*    * *m  ** *    * 4 7     #
# # # # # # # # # # # # # # # #
#*   * *    x*  * *  *   *    #
# # # # # #x#*# #*# # # #*#*# #
#   7     *       7*  6   *   #
###############################
