5 13 31
###############################
#p *     ***   *3  *        * #
# # # # # # #*# #*# #*# # #*# #
#* ** *      ***          *  *#
# #*# # # # # # # # # # # # # #
#  *    3        *   *       *#
# # # #*# #*# # #2# # # #*# # #
#    *    *     x**   *   2   #
# # # # #x# # # #*# # # # # #*#
# *     *   ** 32      * 2   *#
# # # # # # #*# # # # # #*#*# #
#   ***       **b * * *       #
###############################
