17 13 31
###############################
#p     *  *           x**     #
# # # #*# # # # # # #*#*# # # #
#  *    * *   *   x***  *  3 3#
# # # # # # #*# # # # # # # # #
# *   * *        *   **       #
# # # # #*# #3# #3# # # # # # #
#*     *        5** *      *5 #
#*# # #*# # # #*# #*# # #*# # #
#*      * *  3    *   *     * #
#*# # # #7# # # # # # # # # # #
#b                            #
###############################
