35 13 31
###############################
#p        *     5 *    *  *   #
# # # # # # # # #*# # # # # # #
#   *     * *      x7  * * ***#
#*# # # # # #*# # # #5# # # # #
#             *  *  3   *  *  #
# # # # # # # # # # # # # # # #
#        *  *         4     * #
# # # #*# # # # # #*#*# #*# #7#
#    3  *m* ** *      *       #
#*# # # # # #*# #*#*# # # #*# #
#    *  * *x       6     5    #
###############################
