7 13 31
###############################
#p     f 3    3     2  *      #
# # # # # # # # # #*# # #*# # #
# *      *  *x     5   5 *    #
# # # # # #2# # #*# # # # # #*#
#*   *    ***      *    **    #
# # #*# #*# # # # # # #*#*# # #
#     x * *     *           * #
# # # #*# # # # # # # #*# # # #
#*        *  *  *    ** *     #
# # # # #*# # #*# # # # #*#*# #
#   *     * *        3  *     #
###############################
