14 13 31
###############################
#p            *   *6    *** * #
# #*#x# # # # # # # # # # # # #
#*   * * *  ***      6    m   #
# # # # # # #*# #*# #*# # # # #
#          7    *6* *    *    #
#*#6# # # # # # # # # # # # # #
#*   *   x *6   ** *   6 *    #
# #*# # # # # # # #*# # # #*# #
#        **    *   **    *    #
# # # # # # #*# #*# # # # # # #
#           *   *           6 #
###############################
