20 13 31
###############################
#p   * *     *   ** *  *   *3 #
# # # #*# # # # # # # #*# # #*#
#   *    * 52    *   * 7  **  #
# # # # # #*# # # #*# # # # #*#
#         x      *  4  *      #
# # # # # #*# # # # # # # # # #
#*  x * *      *     d*   *   #
# # # # #*# # # # #*# #5#7# # #
#  *     *              **  6*#
# # # #*# # # # #*# # # #*# # #
# *       **       *       *  #
###############################
