31 13 31
###############################
#p     * *      *   *        *#
# #*# #*# #*# # #*# #*# #3# # #
#   *       *   *  *     * 6  #
# # # # # # # # # # # # #*# #*#
#            *      *     *   #
# # # # # # # # # # # # #5#5# #
#  *   *     *      * 6  **  2#
#*# # # # # #4# # # #*# # #*# #
#  3  x   *   x *2**     *  **#
# # # # #4# # # # # # #*# # # #
#*  ** * *    w   *      **   #
###############################
