28 13 31
###############################
#p    x   *   *   **5   3     #
# # # # # # # #*# # # # # # #*#
#**  *     * *    *  *3   * * #
# # #*# # # # # # # # #*#*# # #
#* *    *   *        *   *    #
# # #*# #*# #*# # # #7# # # # #
#     4*     *       * *  4   #
# # # # # # # # # # # # # # #*#
# ***      2* 3    * ***4     #
#*# #b# # # # # # # # # #*# # #
#         *     * *   *    x  #
###############################
