16 13 31
###############################
#p         *     *    5   *   #
# #*# #*# # # # # # # #*#*# # #
#** *    x     5** *    *     #
# # # # # # # # #*#*#*# # # # #
#  *  *  x  *     **    *  ** #
# # #7# # # # # # # # # #*# #*#
#*          *  *          ***5#
# # # #*#*# # # # # # #*# # # #
# *4*    * w          ****    #
# # # # #*#*# # # # # # # #*# #
#   4        4       ** 5     #
###############################
