4 13 31
###############################
#p          * *     * *2    * #
# # #*# # # # # # # # # # #3# #
#   *s  *         *  * *   ** #
# # #*# # #*# # # # # # #*#1# #
#   x ** **      *     *      #
# # #*# # #*#4# # # #*# #*# # #
#    * **  *       **         #
# # # # # # # #*# # # #*# # #*#
#      *  *    x **    4      #
# #*# # # #*# # # # #3# # #*# #
# *      **          *        #
###############################
