13 13 31
###############################
#p   * *  *   ** *  ** *  4   #
# # # #*# # # # # # # # # #*# #
#**           **      53 4* x #
# #*# #*# #*#*# # # # # # # # #
#*   *   5   * *    *  * *    #
# # #*#*# # # # # # # #*# # # #
#      *          *     **    #
# # # # # # # # # #d# # # #*# #
# * *  * **      4         *  #
# #5# # # # #*# # # # # # # #3#
# *  *   *  3*          x     #
###############################
