47 13 31
###############################
#p      * *  x    *    7 *    #
# # # # # # # # # #*# #*# #*# #
#      **   *    **    *m    *#
# # # # # # # # # # # # # # #*#
#         *              *   *#
# # #*# #*#*#*#*#7# # #*# # # #
#            6 *    *  **     #
# # #*#*# # #5# # #*# # # # #*#
#          * 6 *  * *7    *   #
# #*# # # # # #x# # # # # # # #
#        ** 7   7   * *7    5 #
###############################
