29 13 31
###############################
#p x              *    *      #
# # # # # # # #*# # # # #5# # #
#            **  5            #
#*#*#*# # # #*# #*#*#*#*# # # #
#     *  * **  * *     d  **  #
# #*# # # #*# #x# # # #*# # # #
#          *              7*  #
# # # # # #6# # # # #*#*# #*# #
#    6 7 6 **          *    * #
# # #*# #*# # #*# #*# # # # # #
# 6  *     **         * *  6* #
###############################
