45 13 31
###############################
#p    *            *     *  *7#
# # # # # # # # # # # # # # # #
#*** *                  7 65 *#
# # # # # # #*#*# # # #7# # # #
#***     *      *   *       * #
# #*# # #*# # #*#*# # #*# # #5#
#*  *     * * **  *      * * *#
# # # # # # #*# # #*#*# # # #*#
#*   7 77         **     **  *#
#*# # #x#*# #*#*# #*# # # # # #
#    *               6   x   *#
###############################
