12 13 31
###############################
#p *   *2       3 *      5    #
# # # #*# # # # #*# # # #*# # #
#      *   ****     5  *     *#
#*# #*#*# # # # # # #x# # #*# #
#*    *   ***     *  **  *    #
# # # #*# # #*# # # # # # # # #
# *6    *        * b **    *  #
# # # # #*#*# # # # # # # #x# #
#   **        * 4    *    **5 #
# #*# # # #*# #*# # # # # #*# #
#  5  * *  *    **            #
###############################
