49 13 31
###############################
#p  *        *   * *          #
# # #*#7# # # # # #*# # #7# # #
#7     7*          *         *#
# # #*# # # # #*# # # # # #*# #
#    *            7    5      #
# # #*#*# # # #*# # # # #*# # #
#  *           *   *      x   #
# # # # #*#7# #*# # # #6# # #*#
#**        *    *  **  *   8 e#
# # # # # # #*# # # # # # # # #
#*   *  *   x  *  ** 6* *     #
###############################
