37 13 31
###############################
#p     *       **   * 3  5    #
# # # # # # # # # # # # #*# #*#
#  * *   4       6   *        #
# # #*# # # # # # # # # # #*#*#
#7    *            **   ** *  #
#*#*# # # #*#*# # # # #*# # # #
#  *   *    * *  *5*    *  *  #
# # # #7#*# # # # #*# #x# # #*#
#*    x      *  * **       *  #
# # # # # # # #*#*# # #*# # # #
#7    *      5   ** d **3   * #
###############################
