10 13 31
###############################
#p  **   *                  * #
# # # # # #5# # # # #*# # # # #
#    ** **       *   4   ***  #
# #*# # # #*# # # # # # # # # #
#*   * *   *  2     *        *#
# # # # # # # # # #*# # #*# # #
#    *w * *  x      *     5   #
#*# # # # # #*# # # #*# # # # #
#   *3       *      6* *   *  #
# #*# # # # # #x# # # # # # # #
#    *    **    5      **    *#
###############################
