24 13 31
###############################
#p   *    * *  5 *  6* ***   *#
# #*# # # # # #*# # # # # # # #
#       * *  x**  *   3     * #
# # # #*# #*#*# # # #*# # # # #
#     * *    *    5      *   *#
# # # # #*#5# # # # # # # # # #
#*          *       *       * #
#*# # # #*# # # # # # # #*# # #
#  **    4x7 * **  5     *    #
# #d# # #*# # #*# #*#6# #*# # #
#  * *      *  **         *   #
###############################
