50 13 31
###############################
#p         *       *   *    *x#
# # # # #*# # #x# # # #*# # #*#
#         *  *     *  *   8   #
# # #*# # # # # # #*# #*# # #*#
# *      *         *  * *     #
# # #*# #7# # #*# # # # #*# # #
# *   *   *6**  7           * #
#*# # # #*# # # # # # # # # # #
#7 6   * 7             *    * #
# # # # #*# # # #*#8# # #*# # #
#5      7*        *        *  #
###############################
