26 13 31
###############################
#p    *** **  4 *        *    #
# # # # # # #*# #*# # #*# # #*#
#  *        6  *     *       *#
# # # # # # #*# # # # #1# # #*#
# *   **          7          *#
# # #5#2#*# # # # # # # # # #*#
#  **  *             * **     #
# #*# # # # # # # #x# # # # #*#
#   *         *  *    *      *#
#*# # # # # # # # # #*# #5#x# #
#3 *  *             *    **   #
###############################
