36 13 31
###############################
#p    *     *4   *     x   5  #
# # #*#7# # # #*# # # # # #*# #
#* *     **         4  *  5   #
# # #*# # # # #*# # # # #*# #*#
#              *  7        *  #
# # # # # # # # # #e# # # # # #
#    *    *    * 7  3 x       #
#5# # #*#*# # # # # # # #*#*# #
#**  * *  ** *    *     *  * *#
# # # # # # # # # # # # # # # #
#   *    *   * * *    3  * *  #
###############################
