32 13 31
###############################
#p  * **          *    x *    #
# # # #*# # # # # # # # # # # #
#            *     *   7     *#
# # # #b# # #*# #*# # # # # # #
#  *       * * 4*            4#
#*#*# # # # # # # # #*#*# # # #
#*   4    * *               5*#
# # # # # # # # # # # # # # # #
#5*  3     ** *  * **   * * *2#
# # # # #*# # #*#*#*# # #5#*# #
#  * *     ** x        **    *#
###############################
