23 13 31
###############################
#p  *  5  *    *       ** * b #
# # # # #*# #*# #*# # #*# #*# #
#  * *        *         *     #
# # # # # #*#*# #*# # #*# # #*#
#* *       **    *5         * #
#x# # # # # # #*# # # # # #*# #
#   *           *    *  7     #
# # # # #*# # #*# #*# #*# # #*#
#***   6 3              6  x *#
# # # # #4# # # # # # # # # # #
# *           *   4    * 3    #
###############################
