1 13 31
###############################
#p        *******       * **  #
# #*# # #*#*# #*# # # # # # #*#
# * *    * *    *          *  #
# # # # # #*#*# #*# #*# # #*# #
#   * 1 **      *             #
#x# # #*#*# # # #*# # #*# # # #
#     **    * *  *            #
# # #*#x# # #*#*# # # # # # # #
# * *  ****   *        1      #
# # #*# # # # #*# # #1#f# # #*#
#    *   1              11    #
###############################
