44 13 31
###############################
#p    **                      #
# # # # #*#*# # #*# # # # # #*#
#         * *** **   *   4*   #
# # # # #*# # # #*# # # # # #*#
#        *       *    7 ** 7  #
# # # #*# # # #*# # #7# # # # #
#            * *  * 5* 7 *    #
#*#*#d# # # #*# #*# # # #*# #*#
# * * 5 * *x  * 7*   7   *    #
# # # # # # # # # # # # # #*#x#
# *     *        *  6  * ***  #
###############################
