21 13 31
###############################
#p         *  * *         * **#
# # # # # # # # # #*#*# # # # #
# *            * 6*x *    7 * #
# # #*# # # # # # # # # # #5#*#
#     *****    *    *6  5   6 #
# # # # # # # # # # # # # # #5#
#         *  **    *  *      *#
# # # # # # # # # # # # # # # #
#*     m      *   * *    *   x#
# # # #7# # # # # #*# # # # # #
#*5       **     * *      *   #
###############################
