27 13 31
###############################
#p  *5  *       *  *  *       #
# # # # # # #*# # # # # # #*#*#
#   *  *   *    * * *     5  *#
# # # # # # # # # # # # # # # #
#    * **  6 * *  *  *   *  5*#
# # # # # # # #*# # # #5# # #x#
#      *  * *    2  1*     *  #
# #*# # #*# #f# # # #*# # # # #
#        *     * **   *5 7  * #
# #*# # # # # #*# # # # #x# # #
# *               *  *    * * #
###############################
