0 13 31
###############################
#p  sbfwemd             **x   #
# # # # # # # # # # # # # # # #
#                   **        #
# # # # # # # # # # # # # # # #
#                             #
# # # # # #*#*#*# # # # # # # #
#          *   *              #
# # # # # # # #7# # # # # # # #
#          *    *             #
# # #2# # # #*#*# # # # # # # #
#                             #
###############################