34 13 31
###############################
#p              *7            #
# # # #*# # # # # # #x# # # # #
#*         *                * #
# #*# # #*# #*# # # # # # # # #
# * *     * 5*        x * 4   #
# # #*# #*# # # #*# # # # # # #
#    *    *           **      #
# # # # #3# # # # # # #*# #*#*#
#**5    *      *      * * *4* #
#*# # #*# # # # # # # # # # #4#
# *3*5*      *  7 * **        #
###############################
