42 13 31
###############################
#p        **       *     *4* 5#
# # # # #*# #*# # # # #*# # # #
# w *       7   *  *7**       #
#*# # # # #*# # # # # # # # # #
#    *  * * *       **        #
# # # # # # # # # # # # #*# # #
#***  **          *  *  *  7 5#
#*# # # # # # #*#7#x# # # # # #
#         ** 6     *    *7    #
#x#*# # # # # # # # #*# #*# #*#
#*   *                     5  #
###############################
