2 13 31
###############################
#p     2   1        *  ** 2  *#
# # # # # # # # # # # #*# # # #
#*  ***      b  *  *     *    #
#*#*#*#*# # #*# # # # #*# # #*#
#*    *  *  *      *  x   *** #
# # # # # #*# # # #x# # #*#*# #
# *     *   *     *           #
# # # # # #*# # # # # #*# # # #
# *   2      * **        *    #
# # # # # # # # # # # # # # # #
#    ***1 *               *1  #
###############################
