41 13 31
###############################
#p  *   ***    x*          ** #
# #*#*# # # # # # #*# #6# #*# #
# ** *       *  **        5   #
#*# #*# #*# # # # #*# # # # # #
#    * * *   *   7        *   #
# # # # # # #*# # # #*# # # # #
# *   7   7           *       #
# # # # # # # # # # # # # #5# #
# 5   *3      *   4 *      7  #
# # # # # # # # # # # #*#*# # #
#          x d     *   *   *  #
###############################
