8 13 31
###############################
#p     *4  ** *          **   #
# # # #*# # # #*# # # # # # # #
#     *  *    *    *  4 ***   #
# # # #x# # # # # # # # # # # #
#         2*3  *          *   #
# # # #*# #*# # #*# #3# #*#*# #
#**       **      d     *     #
# # # # # # # # # # #*# # # # #
#   *  *         4** **       #
# # #*#*# # # # #*# #*# # # # #
# x       4 *    * *          #
###############################
