15 13 31
###############################
#p             * *   45  **x  #
# # # # #*# #*#*# #*# # # # # #
#*** * *     *  ** ***       *#
# # # # #*# # # # # # # # # #*#
#** *  *          * *  4  f  *#
# # # # # #*# # # # # # # #*# #
# *     *      x    *         #
# #*# # # #*#*# #*# #*# # # # #
#       5*            5   73  #
# # # # # # # # # # # # # # # #
#            *    ***     4   #
###############################
