18 13 31
###############################
#p  2  *        2   *  *      #
# # # # # #*# # #*# # # # # #*#
# **    *    *  m     2   x*  #
# #*# # # # #*# # # # #*#*#*#*#
#       *  *             *    #
# #*# #*#*# # # # # # # # # # #
#  * 1       * **        *   *#
# # # # #*# # # # #*# # # #*# #
#  ***       2   *7 7        *#
#1# # # # # # # # #x#*# # # # #
#* * * ***        1  **     * #
###############################
