33 13 31
###############################
#p  ** *   4*   * ***  *    **#
# # # #*#5# # # # # # # # # # #
#   *3 d    *   *  * *        #
#*# # # # #*# # # # # # # # # #
#  * **    **   *   *         #
#x# # #*#*# # # # # # # # # # #
#*    * 6  *     *      x *   #
# # # # #*# # # # # # # # # # #
#   5          * *   3   7 7  #
#*#4# # # #*# # # # # # # # # #
#5 *    * *      *            #
###############################
