39 13 31
###############################
#p      **       * *x*    *   #
# # # # # # # # #w# # # #*# #*#
#     **  * * *   *    *  63  #
# #*# # # # # # #*# # # #*#*# #
#       7  *** x    *      *  #
# # # # # # #*#7# # # # #*# #*#
#  *          *     ** 6  7   #
# #*#5# # # # #*#*#*# # #*#4# #
# *  *             **      *  #
# # # #*#5# #*# # # # # #*#*# #
#        * *     7    *    *  #
###############################
